1111111111111111111111
1010001011101110101111
1010101111111111111011
1000000P000000O0001111
1011101011111010111011
1111111011101010001011
1000111011111000111011
1010101011111110101011
1110111010001010111011
1000C00C101010000000E1
1111111111111111111111